11111111111
1CCCCCCCCE1
1CCCCPCCCC1
11111111111