11111111111
1CCCCCCCEC1
1CCCCPC1111
11111111111