111111111111111111111111111111111111111111111111111111111111
1E0000000000000000000000000000000000000000000000000000000011
10100101C010000000000000000000000000000000000000000000000011
101001C01010000000000000000000000000000000000000000000000011
1P0000000C00000000000000000000000000000000000000000000000011
100000000000000000000000000000000000000000000000000000000001
100000000000000000000000000000000000000000000000000000000001
100000000000000000000000000000000000000000000000000000000001
100000000000000000000000000000000100000000000000000000000001
100000000000000000000000000000000000000000000000000000000001
100000000000000000000000000000000100000000000000000000000001
100000000000000000000000000000000000010000000000000000000001
100000000000000000000000000000000100000000000000000000000001
100000000000000000000000000000000000010000000000000000000001
100000000000000000000000000000000000000000000000000000000001
100000000000000000000000000000000000000000000000000000000001
100000000000000000000000000000000000000000000000000000000001
100000000000000000000000000000000000000000000000000000000001
100000000000000000000000000000000000000000000000000000000001
100000000000000000000000000000000000000000000000000000000001
100000000000000000000000000000000000000000000000000000000001
100000000000000000000000000000000000000000000000000000000001
100000000000000000000000000000000000000000000000000000000001
111111111111111111111111111111111111111111111111111111111111