1111111111111111111111111111111111
1E0000001000000C00000C000000000001
1P0000000C00C0000000000000100000C1
1010010100100000101001000001000101
1000000010001010000001000000000101
100000000C00C0000000000001000000C1
1010010010101010001001000000010101
1111111111111111111111111111111111