111111111111111111111
10000001000000C000001
1P0C11100C00C00000001
1C1001010010000010101
100000001001110E00001
100000000C01C000000C1
100000000001000000001
101001001010101000101
100001000C00C00000001
111111111111111111111