1111111
1101101
1PE1C11
1111111