1111111
1P00CE1
1011111
1000001
1111101
     11